NO ./assets/themes/mainstream/beehives.xpm
SO ./assets/themes/mainstream/Gold1.xpm
WE ./assets/themes/mainstream/WaterF1.xpm
EA ./assets/themes/mainstream/WalkStone.xpm

F 255,1,255
C 1,1,100

111111111111111111111111111111
100000000000000000000000000011
100000000000000000000000000011
100000000000000000000000000011
100000000000000000000000000011
100000000000000000000000000011
100000000000000N00000000000011
100000000000000000000000000011
1000000000000000000000Z0000011
100000000000000000000000000011
111111111111111111111111111111
