NO ./assets/themes/clashofclans/diamond_wall_coc.xpm
SO ./assets/themes/mainstream/Gold1.xpm
WE ./assets/themes/mainstream/WaterF1.xpm
EA ./assets/themes/mainstream/WalkStone.xpm

F 255,255,255
C 1,1,100

		1111111111111111111111111
        1000000000110000000000001
		1011000001110000000000001
        100100000000000000000000111111111111111111111111111111111111
 1111111110110000011100000000000000000000000000000000000000000000001
 1000000000000000011101111111111111111111111111111111111111111111101
 11110111111111011100000010001								     101
 11110111111111011101010010001                                   101
 11000000110101011100000010001                                   101
 10000000000000000000000000001									 101
110000000000000001101010010001111111111111111111111111111111111111011111111111111
1000000000S0000000000000000000000000000000000000000000000000000000000000000000001
1000000111000101110111101000111111111111111111111111111111111111111111111000000111
11111111 100111111111111111111										  111000000111
         1001														111000000111
		 1001														111000000111
		 1001														111000000111
		 1001														111000000111
		 1001														111000000111
		 1001														111000000111
		 1001														111000000111
		 1001														111000000111
		 1001														111000000111
		 1001														111000000111
		 1001														111000000111
		 1001														111000000111
  	 	 100111111111111111111111111111111111111111111111111111111111111100000011						
	   11100000000000000000000000000000000000000000000000000000000000000000000001
	11110000000000000000000000000000000000000000000000000000000000000000000011111
   11110000000000000000000000000000000000000000000000000000000000000000000011
   11110000000000000000000000000000000000000000000000000000000000000000000011
      1111111111111111111111111111111111111111111111111111111111111111111111