NO ./assets/themes/clashofclans/diamond_wall_coc.xpm
SO ./assets/themes/mainstream/Gold1.xpm
WE ./assets/themes/mainstream/WaterF1.xpm
EA ./assets/themes/mainstream/WalkStone.xpm

F 255,255,255
C 1,1,100

		1111111111111111111111111
        1000000000110000000000001
		1011000001110000000000001
        100100000000000000000000111111111111111111111111111111111111
 1111111110110000011100000000000000000000000000000000000000000000001
 1000000000000000011101111111111111111111111111111111111111111111101
 11110111111111011100000010001								     101
 11110111111111011101010010001                                   101
 11000000110101011100000010001                                   101
 10000000000000000000000000001									 101
1100000000000000011010100100011111111111111111111111111111111111110111
1000000000E00000000000000000000000000000000000000000000000000000000001
1000000111010101110111101000111111111111111111111111111111111111111111
11111111 1011111 111111111111
         101
		 101
		 101
		 101
		 101
		 101
		 101
		 101
		 101
		 101
		 101
		 111
  	 	 111