NO ./assets/themes/clashofclans/wallvines4.xpm
SO ./assets/themes/clashofclans/wallvines1.xpm
WE ./assets/themes/clashofclans/wallvines2.xpm
EA ./assets/themes/clashofclans/wallvines3.xpm

F 4,155,4
C 1,33,144
													11   1
													1 1  1
													1  1 1
													1   11
						1111111111111111111111111
				        100000000011000000000000111111111111111111111111111111111111111
						101100000111000000000000111111111111111111111111111111111111111
				        100100000000000000000000111111111111111111111111111111111111111
				 1111111110110000011100000000000000000000000000000000000000000000001111
				 1Z00000000000000011101111111111111111111111111011111111111111111101111
				 11110111111111011100000010001				111D111			     101111
				 11110111111111011101010010001              1Z00001              101111
				 11000000110101011100000010001              1000001              101111                            
				 10000000000000000000000000001				111D111				 101111111111111111
				11000000000000000110101001000111111111111111111011111111111111111101111111111111111                  						
				1000000000N000000000000000000000000000000000000000000000000000000000000000000000111       
				10000001110001011101111010001111111111111111100001111111111111111111111110000001111   	
				11111111 100111111111111111111				100001					111111100000011
				         1001								100001					1111111000000111
						 1001								100001		 			1111111000000111
						11001								100001					1111111000000111
	1	1	1 			10001111111111111111111111111111111111D111111111111111111111111000000111111   			1111
	 1 1 1 1			10000D0000000000000000000000000000000000000000000000000000000D0000000111   				1
	  1	  1				11D111000000000Z00000000000000000000000000000000000000000000111000000111   				111
	  	  				 100111111111111111111111111111D1111111111111111111111111111111000000111   				1
						 1001					111000000111						111000000111   				1111
						 1001					111000000111						1110000Z0111
						 1001					111000Z00111						111000000111
						 1001					111000000111						111000000111
						 1001					111000000111						111000000111
				  	 	 100111111111111111111111111D11111111111111111111111111111111111100000011						
					   11100000000000000000000000000000000000000000000000000000000000000000000001
					11110000000000000000000000000000000000000000000000000000000000000000000011111
				   11110000000000000000000000Z00000000000000000000000000000000000000000000011
				   11110000000000000000000000000000000000000000000000000000000000000000000011
				      1111111111111111111111111111111111111111111111111111111111111111111111

					  								1111
													1
													1111
													   1
											 		1111






