NO ./assets/themes/clashofclans/wallvines1.xpm
SO ./assets/themes/clashofclans/wallvines2.xpm
WE ./assets/themes/clashofclans/wallvines3.xpm
EA ./assets/themes/clashofclans/wallvines4.xpm

F 0,128,0
C 135,206,235

111111111111111111111111111111
100000000000000000000000000011111111111111111111111111111111111111111111111111111111111111
100000000000000000000000000011000000000000000000000000000000000000000000000000000000000001
100000000000000000000000000011000000000000000000000000000000000000000000000000000000000001
100000000000000000000000000000000000000000000000000000000000000000000000000000000000000001
100000000000000N00000000000011000000000000000000000000000000000000000000000000000000000001
100000000000000000000000000011000000000000000000000000000000000000000000000000000000000001
100000000000000000000000000011000000000000000000000000000000000000000000000000000000000001
100000000000000000000000000011000000000000000000000000000000000000000000000000000000000001
111111111111111111111111111111000000000000000000000000000000000000000000000000000000000001
100000000000000000000000000011000000000000000000000000000000000000000000000000000000000001
100000000000000000000000000011000000000000000000000000000000000000000000000000000000000001
1000000Z0000000000000000000011000000000000000000000000000000000000000000000000000000000001
100000000000000000000000000011000000000000000000000000000000000000000000000000000000000001
100000Z0000000000000000000000D000000000000000000000000000000000000000000000000000000000001
100000000000000000000000000011000000000000000000000000000000000000000000000000000000000001
100000000000000000000000000011000000000000000000000000000000000000000000000000000000000011
1000000000000000000000Z0000011000000000000000000000000000000000000000000000000000000000001
100000000000000000000000000011000000000000000000000000000000000000000000000000000000000001
111111111111111111111111111111111111111111111111111111111111111111111111100000111111111111
                                                                        11000011
                                                                        11000011
                                                                        111111111
