NO ./assets/themes/diamondworld/diamond_wall1.xpm
SO ./assets/themes/diamondworld/diamond_wall2.xpm
WE ./assets/themes/diamondworld/diamond_wall3.xpm
EA ./assets/themes/diamondworld/diamond_wall1.xpm

SPAWNER ./assets/themes/diamondworld/diamond_spawner.xpm
SPRITE ./assets/themes/diamondworld/diamond_sprite.xpm
DOOR_OPEN ./assets/themes/diamondworld/diamond_door_open.xpm
DOOR_CLOSED ./assets/themes/diamondworld/diamond_door_closed.xpm
SPRITE_BOSS ./assets/themes/diamondworld/diamond_boss.xpm

F 128,128,128
C 255,105,180





                              111111111111111111111                                                   11111111111111111   
                              111000000000Z00000011                                                   111000000011111111111111111111111111111111111111111111111111111111111111111111111111111111111111111111111111111111111111111111111111111111111111111111111111111111
                              11100000B00B00B000011                                                   11110000000DDD000000000000000000000000000000000000000000000000000000000000000000000000000000000000000000000000000000000000000000000000000000000000000000000ZZZ1111
                              111000000000000000011                                                   11100Z000011111111111111111111111111111111111111111111111111111111111111111111111111111111111111111111111111111111111111111111111111111111111111111111111110000111
                              111000000000000000111                                                   1110000000111                                                                                                                                          1111000011111
111111111111111111111111111111111100000000000000001111111111111111111111111111111111111111            1110000000111                                                                                                                                           11110000111
11100000000000000N000000000000000000000000000000000000000000000000000000000000000000000011            1110000000111                                                                                                                                           11110000111
11111111111111111111D11111111111111111111111111111111D11111111111111111111111111111110001111111111111111000000011111111                                                                                                                                       11110000111
111000000000000000000000000000000000000000000000000000000D0000000000000000000000000000000000000000000000000000000000111111111111111111111111111111111111111111111111111111111111111111111111111111111111111111111111111111111111111111111111111111111111111111111DDDDD111
1110000000000000000000Z00000000000000000000000000000000001111111111111111111111111000000000000000000000000000000000000000000000000000000000000000000000000000000000000000000000000000000000000000000000000000000000000000000000000000000000000000000000000000000000000011
1110000000000000000000000000000000000000000000000000000001000000000000000000001111000000000000000000000000000000000000000000000000000000000000000000000000000000000000000000000Z00000000000000000000000000000000000000000000000000000000000000000000000000000000000000011
11100000000000000000000000000000000000000000000000000000010000000000000000000011110000000000000000000000000Z00000000000000000000000000000000000000000000000000000000000000000000000111111111111111111111111111111111111111111111111111111111111111111111111111111111111111
111000Z000000000000000Z0000000000000000000000000Z00000000100000Z000Z000Z000Z0011110000000000000000000000000000000001111111111111111111111111111111111111111111111111111111111DD11111111                                                11
1110000000000000000000000000000000000000000000000000000001000000000000000000000111100000000000000000B00000000000000011111111111111111111111111111111111111111111111111111110000000000111
1110000000000000000000000000000000000000000000000000000001111111111111111111111111000000000000000000000000000000000111100000000000000000000000000000000000000000000000011100000000001111                      
1111111111111111111111111DD1111111111111111111111111111111111111111111111111111111111111111111111111111111111111111111111000000000000B0000011111111000000000000000000011110000011111
                 100000000001                                                                                   100000000000000000000000011111001100000000000000000000001111000001111
                 100000000001                                                                                   1000000000000000000000000111000111000000000000B00000000011000000111
                 100000000001                                                                                   1000000000000B0000111100000111100000000000000000000111000001111
                 100000000001                                                                                   1000000000000000000000011110000000111111111111111111111111110011111
                 100000000001                                                                                   100000000000000000000000111100000000000000000000000000000D000000111
                 100000000001                                                                                   1000000000000000000000000111100000000000000000000000000000D00000011
                 100000000001                                                                                   10000000000000000000B0011111111111111111111111111111111111100000011
                 100000000001                                                                                   1000000000000000000000000000000000000000111B000000000000110000001111
                 100000000001                                                                         11111111111110000000000000000000000000000000011100000000000000001111100000011
111111111111111111111DD1111111111111111111111111111111111111111111111111111111111111111111111111111111111000000111100000000000000000000000000000000000000000000000001111110000011111
10000000000000000000000000000000000000000000000000000001111111111111111111111111100000000000000000000000000000000111100000000000000000B0000000000000000000000000000001110000000000111
111111111111111111111111111111111111111111111111110000111111111111111111111111111000000000B0000000000000000ZZZZ0001111BB000000000000000000000000000000000000000000000111000000000011111                                                  
                                                110000111                       111000000000000B00000001111111111111111ZZZ00000000000000B0000000000000000000B0000000111111000000000011
                                                110000111                        11000000000000000000001111111111111111000000000000000000000000000000000000000000000011000000000011111
                                                110000111                       1100000000000000000000111111111111111100000000000000000000000000000000000000000000000110000000000111  
                                                110000111                       110000000000000000000011111111111111111111111111111111111111111111111111111111111111111000000000011111
                                                110000111                      11000000000000000000000000000000000000000000000000000000000000000000000000000000000000000000000000001111
                                                110000111111111111111111111111111110000000000000000000000000000000000000000000000000000000000000000000000000000000000000000000000000011
                                                1100000000000000000000000000000000000000000000000000001111111111111111111111111111111111111111111111111111111111111111111111111111111111
                                                11111111111111111111111111111111111111000000000000000000001111111111111111
                                                                            111111111000000000000000000001111111111111111
                                                                            111111111000000000000000000001111111111111111                                                                                                   
                                                                            11111111111111DDD111111111111111111111111                                               
                                                                                    111111000011                                               
                                                                                    111111000011111                                              
                                                                                    11111000000011                                             
                                                                                    111100000000111                                            
                                                                                  1111100000000000111                                           
                                                                                   111000000000001111                                          
                                                                                 111110000000000011111                                         
                                                                                111100000000000000001111                                       
                                                                               11100000000000000000001111                                       
                                                                              111000000000000000000001111                                      
                                                                             111000000000000000000000001111                                    
                                                                            111000000000000B0000000000011111                                    
                                                                           1110000000000000000000000000001111                                   
                                                                          111000000000000000000000000000001111                                  
                                                                         11100000000000000000000000000000001111                                 
                                                                        1110000000000000000B00000000000000001111                                
                                                                       111000000000000000000000000000000000001111                               
                                                                      11100000000000000000000000000000000000001111                              
                                                                     11100000000000000000000000000000000000000011111                             
                                                                    11100000000000000000000B000000000000000000001111                            
                                                                   11100000000000000000000000000000000000000000001111                           
                                                                  1110000000000000000000000000000000000000000000001111                          
                                                                 11100000000000000Z0000000000Z0000000000000000000001111                         
                                                                111000000000000000000000000000000000000000000000000011111                        
                                                               1110000000000000000000000000000000000000000000000000001111                       
                                                              111000000000000000000000000000000000000000000000000000001111                      
                                                             11100000000000000000000000000000000000000000000000000000011111                    
                                                            1110000000000000000000000000000000000000000000000000000000011111                     
                                                           111000000000000000000000000000000000000000000000000000000000011111                    
                                                          11100000000000000000000000000000000000000000000000000000000000011111                   
                                                         1110000000000000000000000000000000000000000000000000000000000000011111                  
                                                        11100000000000000000000000ZZZ0000000ZZZZ000000000000000BBB00000000011111                
                                                       11100000000000000000000000000000000000000000000000000000000000000000011111 
                                                        11100000000000000000000000000000000000000000000000000000000000000B011111  
                                                         1110000000000000000000000000000000000000000000000000000000000000011111 
                                                          111000000Z000000000000000000000000000000000000000000000000000011111 
                                                           111000000000000000000000000000000000000000000000000000000000011111 
                                                            1110000000000000000000000000000000000000000000000000000000011111 
                                                             11100000000000000000000000000000000000000000000000000000011111 
                                                              111000000000000000000000000000000000000000000000000000011111 
                                                               1110000000000000000000000000000000000000000000000000011111 
                                                                11100000000000000000000000000000000000000000000000011111 
                                                                 11100000000000000000000000B000000000000000000000011111 
                                                                  1110000000000000000000000000000000000000000000011111 
                                                                   11100000000000000000000000000000000000000000011111 
                                                                    111000000000000000000000000000000000000000011111 
                                                                     1110000000000000000000000000000000000000011111 
                                                                      11100000000000000000000000000000000000011111 
                                                                       111000000000000000000000000000000000011111 
                                                                        1110000000000000000000000000000000011111 
                                                                         11100000000000000000000000000000011111 
                                                                          111000000000000000000000000000011111 
                                                                           1110000000000000000000000000011111 
                                                                            111000000000Z00000Z0000000011111 
                                                                             111000000000000000000000011111
                                                                              1110000000000000000000011111 
                                                                               11100000000000000000011111 
                                                                                111000000000000000011111 
                                                                                 1110000000000000011111 
                                                                                  11100000000000011111 
                                                                                   111000000000011111 
                                                                                1111110000000011111 
                                                                                1111111100000011111 
                                                                                   111111000011111
                                                                                    111110011111 
                                                                                    111111111
                                                                                        1 