NO ./assets/themes/hell/hellwall1.xpm
SO ./assets/themes/hell/hellwall2.xpm
WE ./assets/themes/hell/hellwall3.xpm
EA ./assets/themes/hell/hellwall4.xpm

SPAWNER ./assets/themes/hell/hell_spawner.xpm
SPRITE ./assets/themes/hell/imp.xpm
DOOR_OPEN ./assets/themes/hell/hell_door_open.xpm
DOOR_CLOSED ./assets/themes/hell/hell_door_closed.xpm
SPRITE_BOSS ./assets/themes/hell/demon_boss.xpm

F 0,0,0
C 150,0,0

                 111
                 1Z1
                 101    
                 101
111111111111111111D111111111111111111111111111111111111111111111111111111111111111111111
100000000000000N00B0BB000000000000000000000000000000000000000000000000000000000000000011
111111111111111111D11111111111111111111111111111111D1111111111111111111111111111111000111111111111111111111111111111
1000000000000000000000000000000000000000000000000000000D00000000000000000000000000000000000000000000000000000000001111
10000000000000000000Z000000000000000000000000000000000011111111111111111111111110000000000000000000000000000000001111
100000000000000000000000000000000000000000000000000000010000000000000000000011110000000000000000000000000000000001111
100000000000000000000000000000000000000000000000000000010000000000000000000011110000000000000000000000000000000001111
1000Z000000000000000Z0000000000000000000000000Z00000000100000Z000Z000Z000Z0011110000000000000000000000000000000001111
10000000000000000000000000000000000000000000000000000001000000000000000000000111100000000000000000B0000000000000001111
100000000000000000000000000000000000000000000000000000011111111111111111111111110000000000000000000000000000000001111
10000000000000000000Z0000000000000000000000000000000000D0000000000000000000000D0000000000000000000B00000000000001111111
100000000000000000000000000000000000000000000000000000011111111111111111111111110000000000000000000000000000000001111
11111111111111111111111111111111111111111111111111111111                       10000000000000000000000000000000001111
                                                                            1111110000000000000000B00000000000000001111
                                                                                10000000000000000000000000000000001111
                                                                                10000000000000000000000000000000001111
                                                                                100000000000000000B0000000000000001111
                                                                                1000000Z000000000000000000000000001111
                    11111                                                       10000000000000000000000000000000001111 							
					11001														11100000011111111111111111111111111111
					11001														111000000111
1	1	1 			100011111111111111111111111111111111111111111111111111111111111000000111   1111
 1 1 1 1			10000D0000000000000000000000000000000000000000000000000000000D0000000111   1
  1	  1				11D111000000000000000000000000000000000000000000000000000000111000000111   111
  	  				1100111111111111111111111111111D1111111111111111111111111111111000000111   1
					11001					111000000111						111000000111   1111
					11001					111000000111						111000000111
					11001					111000000111						111000000111
					11001					111000000111						111000000111
					11001					111000000111						11100000011111111111111111111111111111
                    11111                   111111111111                        10000000000000000000000000000000001111
                                                                                10000000000000000Z00000000000000001111
1111111111111111111111111111111111111111111111111111111111111111111111111111111111000000000000000Z00000000000000001111
 11000000000000000000000000000000000000000000000000000000000000000000000000000000000000000000000000Z0000000000000000111
 111111111111111111111111111111111111111111111111111111111111111111111111111111111110000000000000000Z00000000000000001111
                                                                                10000000000000000Z00000000000000001111
                                                                                10000000000000000Z00000000000000001111
                                                                                10000000000000000Z00000000000000001111
                                                                                10000000000000000Z00000000000000001111
                                                                                10000000000000000Z00000000000000001111
                                                                            1111110000000000000000Z00000000000000001111
1111111111111111111111111111111111111111111111111111111111111111111111111111111111111111111111111111111111111111DD1111
1000000000000000000000000000000000000000000000000000000000000000000000000000000000000000000000000000000000000000000011
10000011111111D11111111100000000000000000000000000000000000000000000000000000000000000000000000000000000000000000001111
10000010000Z000000000001000000000000000000000000000000000000000000000000000000000000000000000000000000000000000000011
100000100000000000000001000000000000000000000000000000000000000000000000000000000000000000000000000000000000000000011
100000100000000000000001000000000000000000000000000000000000000000000000000000000000000000000000000000000000000000011
10000010000Z000000000001000000000000000000000000000000000000000000000000000000000000000000000000000000000000000000011
100000100000000000000001000000000000000000000000000000000000000000000000000000000000000000000000000000000000000000011
10000010000000000000000100000000000000000000000000Z000000000000000000000000000000000000000000000000000000000000000011
100000D0000000000000000D000000000000000000000000000000000000000000000000000000000000000000000000000000000000000000011
100000100000000000000001000000000000000000000000000000000000000000000000000000000000000000000000000000000000000000011
100000100000000000000001000000000B00000000000000000000000000000000000000000000000000000000000000000000000000000000011
100000100000000000000001000000000000000000000000000000000000000000000000000000000000Z00000000000000000000000000000011
100000100000000000000001000000000000000000000000000000000000000000000000000000000000000000000000000000000000000000011
100000100000000000000001000000000000000000000000000000000000000000000000000000000000000000000000000000000000000000011
100000100000000000000001000000000000000000000000000000000000000000000000000000000000000000000000000000000000000000011
100000100000000000000001000000000000000000000000000000000000000000000000000000000000000000000000000000000000000000011
1000001000000Z000000001000000000000000000000000000000000000000000000000000000000000000000000000000000000000000000011
11111111111111111111111111111111111111111111111111111111111111111111111111111111111111111111111111111111111111111111111111