NO ./assets/themes/hell/hellwall1.xpm
SO ./assets/themes/hell/hellwall2.xpm
WE ./assets/themes/hell/hellwall3.xpm
EA ./assets/themes/hell/hellwall4.xpm

SPAWNER ./assets/themes/hell/hell_spawner.xpm
SPRITE ./assets/themes/hell/imp.xpm
DOOR_OPEN ./assets/themes/hell/hell_door_open.xpm
DOOR_CLOSED ./assets/themes/hell/hell_door_closed.xpm
SPRITE_BOSS ./assets/themes/hell/demon_boss.xpm

F 0,0,0
C 150,0,0

11111111111111111111111111111111111111111111111111111111111111111111111111111111111111111111111111111111111111111111111
1111             111111            111111111111111111111111111111            111111                                111111111111111111              111111111
1111              1  11        1111111111111111111111111111111111111         1  11                               111111111111111111111111111
1111              1    1     111111111111111111111111111111111111111       1    1                                111111111111111111111111111
1111              1   11111111111111111111111111111111111111111111111   11     1                                111111111111111111111111111
1111              1111111111  1           1   111   1             1  111       1                                111111111111111111111111111
1111               11       1 1111111111     1   1   1       111111111111       1                                111111111111111111111111111
1111                  1    11          11    1       1    111           11    11    1111111111111111111111111111111111111111111111111111111111111111111111111
1111                  11111                   1     1    1                1111      1111000000000000000000000000D00000000000011111111111111111
1111                 1111                1    1     1   1                  11       1000000000000N0000000011111111111111BBBBBBBBB1111
1111                1111  1               11  1  1  1  1                1  111      1000000000000000000000111111111111111111111111111
1111          11    1111   11               111  1  111               11   111      111111111111111111111111111111111111111111111111111111111111
1111          111   1111     111               1 1 1                111    1111    11                                111111111111111111111111111
1111         1  11  1111      11111111111111111  1   11111111111111111     1111  11 1                                111111111111111111111111111
1111         1  1 111111                                                   1111 11   1                               111111111111111111111111111
1111         1  111 1 111111     111111111                1111111111  1111111 11 111 1                               111111111111111111111111111
1111         1  1  11 11    1111  1 11 1  11  1     1   11  1 11 1  11     11 111  1 1                             111111111111111111  111111111
1111         1  11  1 11      111111111111    1     1    111111111111      11 1   1  1                             111111111111111111  111111111
1111         11  1 11 11                11    1     1    11                11 11 1   1                         111111111111111111      111111111
1111           1111 1 1               11      1     1      11               1 1  1 11                          111111111111111111      111111111
1111            11 11          1111111       1       1       1111111          111 1                            111111111111111111  111111111
1111              11 1       11             1         1             111       1  1                         111111111111111111      111111111
1111               111    111              1     1     1               11     111                          111111111111111111      111111111
1111                 11  1                11     1      1                11  11                            111111111111111111  111111111
1111                  11                    1111111111111                   11                             111111111111111111  111111111
1111                    11             1111111111111111111111              1                             111111111111111111111111111
1111                      1          11111111111111111111111111          11                              111111111111111111111111111
1111                       1        1111111111111111111111111111        1                                111111111111111111111111111
1111                        1      1111111 1  111  111  1 1111111      1                             111111111111111111111111111
1111                        11     1111     11        11     1111    11                            111111111  111111111
1111                         11    1111  11              11  1111   11                               111111111
1111                           11  111111  111 11  11 111  111111 111                                111111111
1111                          11 111111111111111111111111111111111   11                              111111111
1111                        11     111111111111111111111111111111      11                                111111111
1111                      11        1111111111111111111111111111         11                              111111111
1111            1111111111           11111111111111111111111111            11111111111                        11111   111111111
1111                                  111111111111111111111111                                               111111111
1111                                  111111111111111111111111                                            111111111
1111                                   11111111111111111111111                                              111111111
1111                                    111111         111111                                                   111111111
1111                                    11111           11111                                                  111111111
1111                                     111             111                                                       111111111
1111                                      11             11111111111                                                    111111111
111111111111111111111111111111111111111111111111111111111111111111111111111111111111111111111111111111111111111111111111111111111111111111111111111111111